heal = г. лечити, видати; и. лечење; п. видарски; /-er и. видар
cure = г. исцељивати; и. исцељивање; /-er и. исцелитељ
resistance = и. отпорност
vulnerability = и. рањивост
zone of control = и. надзорни појас
ZoC = и. напoj
skirmish = г. чаркати се; и. чаркање; /-er и. чаркаш
illuminate = и. обасјавати
lawful = п. законит; и. закон
neutral = п. неутралан; и. неутрал
chaotic = п. хаотичан; и. хаос
dusk = и. сумрак
dawn = и. зора
first watch = и. прва стража
second watch = и. друга стража
morning = (доба дана) и. јутро
afternoon = (доба дана) и. поподне
nightstalk = и. вребање
submerge = и. зарањање
berserk = и. безглавост
backstab = и. нож-у-леђа
marksman = оштроокост
drain = г. црпети; и. црпљење
morning star = и. северњача
commander = и. заповедник
hex = и. хекс
sceptre = и. жезло
staff = и. штап
hitpoint = и. ударпоен
energy bar = и. енерготрака
rating = и. разред
movement = (атрибут јединице) и. покретљивост
shroud = и. покров
fog of war = и. магла рата
fireball = и. ватрокугла
status pane = и. статусно окно
terrain modifier = и. теренски модификатор
time of day = и. доба дана
alignment = и. поредак
intelligent = (особина) и. оштроумност
advance = г. напредовати, испредњачити
After Maximum Level Advancement = и. напредовање по највећем нивоу
AMLA = и. НАПОН
regeneration = (способност) и. обнављање
type = (штете) и. вид
income = и. приход
upkeep = и. издаци
campaign = и. поход
quick = (особина) и. хитрост
resilient = (особина) и. жилавост
strong = (особина) и. кршност
dextrous = (особина) и. спретност
undead = (особина) и. немртвост
dim = (особина) и. ограниченост
slow = (особина) и. тромост
weak = (особина) и. крхкост
grassland = (терен) и. равница
flat = (терен, бивши /grassland/) и. равница
road = (терен) и. друм
frozen = (терен) и. клизавица
castle = (терен) и. замак
keep = (терен) и. кула
pierce = (напад) и. пробој
impact = (напад) и. удар
blade = (напад) и. сечиво
cold = (напад) и. мраз
fire = (напад) и. ватра
holy = (напад) и. светост
tower shield = и. кулин-штит
arcane = (напад) п. волшебни
crush = (напад) и. гажење

Aethenwood = Етенвуд
Caverns of Flame = Пламене пећине
Clearwater = Бистроморска
Dwarven Door = Патуљачке двери
Everlore = Свенаук
Green Isle = Зеленострво
Grey Woods = Седошумље
Halstead = Халстед
Northlands = Североземље
Southbay = Југозалив
Wesmere = Весмер

Aiglondur = Аиглондур
Angarthing = Ангартинг
Chantal = Чантал
Dacyn = Десин
Kalenz = Каленз
Kaylan = Кајлан
Konrad = Конрад
Li'sar = Лизара
Nym = Ним
Thursagan = Турсаган
Zhul = Жул

Northern Alliance = Северњачки савез
